wwwwwwwwwwwwwwww
w      w      dw
w  h  ww       w
wc    w        w
wwww  w  w     w
w  w  w ww     w
w     w w   w ew
w   e w        w
wmw   wc       w
w e   www      w
w     mc     e w
wwwmwww        w
w     w   w    w
w     w   ww   w
wP  w w     h  w
wwwwwwwwwwwwwwww