wwwwwwwwwwwwwwww
w me         mmw
w mc    e  c   w
w          h   w
w              w
w      ww      w
we     h     e w
w            mmw
w         c    w
wh             w
w     e     e  w
w c          www
wmm    c       w
w  m        e  w
wP  m  e   Ce dw
wwwwwwwwwwwwwwww