wwwwwwwwwwwwwwww
w       d      w
w   e          w
w     w   c    w
wmw   w  w     w
wc wwwwmwwwm   w
w   h   w  mw  w
w   e      wwwww
wmw eew        w
w              w
whC ee       ehw
w   ee   e     w
w   ee    ec   w
wwmwee    mmmmmw
w  cee    m  P w
wwwwwwwwwwwwwwww