wwwwwwwwwwwwwwww
wd             w
w   e          w
w     w   c    w
wmw   w  w     w
wc wwwwmww     w
w   h   w   w  w
w   e      wwwww
wmw   w        w
w e   www      w
whC C m      ehw
w    ww   w    w
w    w    wc   w
wwmwww    wwwwww
w  cw    Pwwwwww
wwwwwwwwwwwwwwww