wwwwwwwwwwwwwwww
w c    d    m cw
w   em    mecwmw
wwmmm    m    mw
w  w    m  ecw w
wchm   c       w
wmm  em  e mmh w
w e      m  e  w
w       m em   w
w   e  w CCmC Cw
w      w CeceCCw
w     wC emme Cw
w     mmmm h   w
w     w   CCe  w
wP    w C      w
wwwwwwwwwwwwwwww