wwwwwwwwwwwwwwww
w            wdw
w  w           w
w cw    C c    w
wwww     w     w
wc w    ww     w
w       w   w ew
w   e      wwmww
wmw   w        w
w e   www      w
w     m     ce w
w c  ww        w
w         w    w
wwmww     ww   w
wP cw        c w
wwwwwwwwwwwwwwww